0000000000
0000110000
1111001111
0000000000
0000000000
